<<wapas-svAXyAya>Di-nirawam>T7 
तपः च स्वाध्यायः च = तपस्वाध्यायौ, 
तपस्स्वाध्ययोः निरतः = तपस्स्वाध्यायनिरतः, 
तं तपस्स्वाध्यायनिरतम्

<<<vexa-vexAfga>Di-wawwva>T6-jFaH>Bs6
वेदाः च वेदाङ्गानि च = वेदवेदाङ्गानि, 
वेदवेदाङ्गानां तत्त्वम् = वेदवेदाङ्गतत्त्वम्, 
वेदवेदाङ्गातत्त्वं जानाति इति = वेदवेदाङ्गतत्त्वज्ञः

<<<<<<<pravara-mukuta>Tm-maNi>T6-marIci>T6-maFjarI>K3-caya>T6-carciwam>T3-<caraNa-yugalam>T6>Bs6	
प्रवरराज्ञः मुकुटः = प्रवरमुकुटः
प्रवरमुकुटस्य मणिः = प्रवरमुकुटमणिः
प्रवरमुकुटमणेः मरीचिः = प्रवरमुकुटमणिमरीचिः
प्रवरमुकुटमणिमरीचिः च असौ मञ्जरी च = प्रवरमुकुटमणिमरीचिमञ्जरी
प्रवरमुकुटमणिमरीचिमञ्जर्याः चयः  = प्रवरमुकुटमणिमरीचिमञ्जरीचयः
प्रवरमुकुटमणिमरीचिमञ्जरीचयेन चर्चितम् = प्रवरमुकुटमणिमरीचिमञ्जरीचयचर्चितम्
चरणस्य युगलम् चरणयुगलम्
प्रवरमुकुटमणिमरीचिमञ्जरीचयचर्चितं चरणयुगलं यस्य तत् = प्रवरमुकुटमणिमरीचिमञ्जरीचयचर्चितचरणयुगलम्

<<su-<saMkalpiwa-buxXi>Bs2>K1-yukwaH>T3
सङ्कल्पितः बुद्धिः यं सः = सङ्कल्पितबुद्धिः
शोभनः सङ्कल्पितबुद्धिः  = सुसङ्कल्पितबुद्धिः
सुसङ्कल्पितबुद्ध्या युक्तः = सुसङ्कल्पितबुद्धियुक्तः  

<baxXa-<jAmbUnaxa-srajaH>K1>Bs3
जाम्बूनदः सः स्रजः च = जाम्बूनदस्रजः
बद्धः जाम्बूनदः येन सः = बद्धजाम्बूनदस्रजः

<wyakwa-<sarva-<priya-<na-priyaH>Tn>Di>K1>Bs3
न प्रियः = अप्रियः
प्रियः च अप्रियः च = प्रियाप्रियः
सर्वः सः प्रियाप्रियः च = सर्वप्रियाप्रियः
त्यक्तः सर्वप्रियाप्रियः येन सः = त्यक्तसर्वप्रियाप्रियः

<wyakwa-<<sarva-inxriya>K1-kriyaH>T6>Bs3
सर्वम् तत् इन्द्रियं च = सर्वेन्द्रियम्
सर्वेन्द्रियस्य क्रियः = सर्वेन्द्रियक्रियः
त्यक्तः सर्वेन्द्रियक्रियः येन सः= त्यक्तसर्वेन्द्रियक्रियः

<vinIwa-<kroXa-harRaH>Di>Bs3
क्रोधः च हर्षः च = क्रोधहर्षौ
विनीतः क्रोधहर्षः येन सः= विनीतक्रोधहर्षः

<apewa-<gqha-XarmaH>T6>Bs3
गृहस्य धर्मः = गृहधर्मः
अपेतः गृहधर्मः येन = अपेतगृहधर्मः

<nyaswa-<sarva-AyuXasya>K1>Bs3
सर्वं तत् आयुधं च = सर्वायुधम्
न्यस्तं सर्वायुधं येन तत् = न्यस्तसर्वायुधम्
तस्य न्यस्तसर्वायुधस्य
